 7 
 1  2  4  1  3  2  2 
 12 
 1  1  2  2  1  1  2  1  1  1  1  1 
 13 
 1  1  1  2  1  2  1  1  1  1  1  1  1 
 4 
 4  3  5  3 
 8 
 1  2  1  1  2  2  2  4 
 10 
 1  2  2  1  2  1  2  1  2  1 
 14 
 1  1  1  1  1  1  1  1  1  1  2  1  1  1 
 4 
 3  6  4  2 
 8 
 2  2  2  1  1  1  2  4 
 11 
 2  2  2  1  1  1  2  1  1  1  1 
 11 
 1  1  1  2  1  1  1  2  2  1  2 
 2 
 13  2 
 5 
 1  3  1  5  5 
 14 
 1  2  1  1  1  1  1  1  1  1  1  1  1  1 
 14 
 1  1  1  1  1  1  1  1  2  1  1  1  1  1 
