 10 
 1  3  3  2  2  4  2  1  1  1 
 14 
 1  1  2  1  2  1  2  1  1  1  1  1  2  3 
 11 
 2  2  2  1  1  1  1  2  1  2  5 
 14 
 2  1  2  2  1  2  1  1  1  1  1  2  1  2 
 5 
 3  4  3  2  8 
 7 
 1  1  1  1  3  1  12 
 8 
 2  2  3  1  1  4  4  3 
 14 
 1  2  1  1  2  1  2  2  2  2  1  1  1  1 
 15 
 1  1  2  2  1  2  1  2  1  1  2  1  1  1  1 
 9 
 3  3  2  4  3  2  1  1  1 
 8 
 2  3  3  1  3  2  4  2 
 14 
 1  2  1  1  2  2  1  2  1  2  1  1  2  1 
 3 
 5  4  11 
 11 
 1  1  1  1  1  1  1  1  2  1  9 
 13 
 1  1  2  1  2  2  2  1  1  2  2  1  2 
 1 
 20 
 6 
 2  2  1  3  3  9 
 13 
 1  2  2  1  2  1  1  2  2  2  1  1  2 
 4 
 9  6  4  1 
 5 
 6  2  1  4  7 
