 14 
 2  1  1  1  1  1  1  1  1  1  1  1  1  1 
 14 
 1  1  1  1  2  1  1  1  1  1  1  1  1  1 
 7 
 3  3  2  1  1  3  2 
 6 
 2  1  4  1  1  6 
 9 
 1  1  2  1  1  1  1  1  6 
 10 
 1  2  1  2  1  2  1  1  2  2 
 4 
 1  5  2  7 
 13 
 1  1  1  1  2  1  1  1  1  2  1  1  1 
 3 
 10  1  4 
 6 
 2  1  2  2  3  5 
 7 
 1  2  1  4  3  1  3 
 15 
 1  1  1  1  1  1  1  1  1  1  1  1  1  1  1 
 12 
 1  2  1  1  2  1  1  1  1  2  1  1 
 3 
 9  2  4 
 12 
 2  1  1  1  1  2  1  1  2  1  1  1 
 10 
 2  1  1  2  2  2  1  1  2  1 
 8 
 2  2  1  1  1  2  2  4 
 9 
 1  1  1  1  1  2  1  2  5 
 3 
 3  2  10 
 14 
 1  1  1  1  1  1  1  1  1  2  1  1  1  1 
 12 
 2  1  2  1  2  1  1  1  1  1  1  1 
 11 
 1  1  2  1  2  1  2  2  1  1  1 
 15 
 1  1  1  1  1  1  1  1  1  1  1  1  1  1  1 
 10 
 2  2  1  2  1  2  1  1  1  2 
 8 
 1  2  1  2  1  2  1  5 
 8 
 2  2  2  1  2  1  1  4 
 5 
 3  3  6  2  1 
 2 
 1  14 
 14 
 1  1  1  1  1  2  1  1  1  1  1  1  1  1 
 8 
 2  1  1  1  1  1  1  7 
