 8 
 3  2  3  3  3  3  1  2 
 10 
 1  3  2  1  2  1  1  4  4  1 
 6 
 3  4  5  2  2  4 
 11 
 2  2  1  1  1  1  2  1  1  1  7 
 9 
 1  1  1  2  4  4  4  2  1 
 10 
 1  2  3  3  1  2  1  1  3  3 
 3 
 9  8  3 
 15 
 1  1  1  2  1  1  2  2  1  1  2  1  1  1  2 
 14 
 1  2  1  2  2  1  2  1  1  1  2  1  2  1 
 6 
 1  4  3  1  2  9 
 4 
 7  1  4  8 
 4 
 4  3  3  10 
 14 
 1  2  1  1  1  2  1  1  2  1  1  1  2  3 
 2 
 7  13 
 4 
 5  5  8  2 
 13 
 2  1  1  1  2  1  2  1  2  1  1  2  3 
 15 
 1  2  1  1  2  1  1  1  1  1  1  1  1  2  3 
 13 
 1  1  1  2  2  1  1  1  1  2  2  2  3 
 1 
 20 
 8 
 2  1  4  1  1  3  3  5 
 9 
 2  4  1  1  1  2  2  3  4 
 4 
 5  10  3  2 
 14 
 1  1  2  1  2  2  1  1  1  1  2  1  2  2 
 7 
 2  3  2  1  3  2  7 
 14 
 2  1  1  1  2  1  2  2  1  2  1  2  1  1 
 15 
 1  1  2  2  2  1  2  1  1  1  2  1  1  1  1 
 10 
 4  1  1  4  1  1  2  4  1  1 
 14 
 2  1  2  1  1  1  2  1  1  2  1  1  1  3 
 1 
 20 
 5 
 7  6  3  3  1 
